0000002222000000
0000223333220000
0022333113332200
0233311551133320
0231140310411320
0231140130411320
0233311551133320
0022333113332200
0000223333220000
0000002222000000