0000000000000000
0000000000000000
0000000000000000
0000000000000000
0000004554000000
0000004114000000
0000004444000000
0000000000000000
0000000000000000
0000000000000000
0000000000000000