3311333113331133
1331133113311331
1133113333113311
3133311331133113
3311331111331133
1331133113311331
4133113333113314
5455445335445545